....................
..............#.....
.....#........#...#.
.....##......##..##.
.....##......######.
....###......#######
....###.....###...##
.....###...###.....#
#.....##..#.........
#.....#####....##...
##.....###.....##...
##.....##......##...
###....##......###..
###.....##.....###..
####.....##..#####..
#.##......#########.
#...........#######.
..............####..
....................
...#######..........