....................
............#.......
............#...#...
........#...#...#.#.
........#...##..####
....#..##..###.#####
...##.##############
...####.##.......###
....#...###..#....##
..#.....#....##....#
..#.....#.....#.#...
...##...#....##.#...
....#...##...#..##..
....##..###....##...
.....###########....
.....###..####......
.....###............
......#..........#..
.................#..
.................##.